11111111
10000C01
10P00001
101000E1
11111111
